11111111111111
10000000000001
10011100000001
10001100000001
10000100000001
10000000000001
10000110000001
10000100000001
10000000000001
10000000000001
10000000000001
10110000000001
10001000000001
11111111111111
